
NO textures/north.xpm 
EA textures/east.xpm
SO textures/south.xpm           
WE textures/west.xpm                

C 199,199,199
F 32,32,32

111111111111
1N0000000001
100000000001
11111111111



11111111111
1001111011111
10100000000001
1100111111111
111111                    111111111111   
         111     1111            1001
         1001            1111   1111               
1111111111111    111    
11111111111
100111101
10100111111
11001
111111                    111111111111   
         111     1111            1001
         1001            1111   1111               
1111111111111    111    
11111111111
100111101
10100111111
11001
111111                    111111111111   
         111     1111            1001
         1001            1111   1111               
1111111111111    111    
11111111111
100111101
10100111111
11001
111111                    111111111111   
         111     1111            1001
         1001            1111   1111               
1111111111111    111    
11111111111
100111101
10100111111
11001
111111                    111111111111   
         111     1111            1001
         1001            1111   1111               
1111111111111    111    
11111111111
100111101
10100111111
11001
111111                    111111111111   
         111     1111            1001
         1001            1111   1111               
1111111111111    111    
11111111111
100111101
10100111111
11001
111111                    111111111111   
         111     1111            1001
         1001            1111   1111               
1111111111111    111    
11111111111
100111101
10100111111
11001
111111                    111111111111   
         111     1111            1001
         1001            1111   1111               
1111111111111    111    
11111111111
100111101
10100111111
1100000001
1111111111    1                111111111111   
         111     1111            1001
         1001            1111   1111               
1111111111111    111    
11111111111
100111101
10100111111
11001
111111                    111111111111   
         111     1111            1001
         1001            1111   1111               
1111111111111    111    
11111111111
100111101
10100111111
11001
111111                    111111111111   
         111     1111            1001
         1001            1111   1111               
1111111111111    111    
11111111111
100111101
10100111111
11001
111111                    111111111111   
         111     1111            1001
         1001            1111   1111               
1111111111111    111    
11111110111
100111101
10100111111
11001
111111                    111111111111   
         111     1111            1001
         1001            1111   1111               
1111111111111    111    